"filename", "language", "Dart", "comment", "blank", "total"
"c:\PROJECTS\FLUTTER\diverzum_due_date\due_date\lib\common_widgets\bottom_navigation.dart", "Dart", 79, 0, 9, 88
"c:\PROJECTS\FLUTTER\diverzum_due_date\due_date\lib\common_widgets\sliver_head_bar.dart", "Dart", 37, 1, 9, 47
"c:\PROJECTS\FLUTTER\diverzum_due_date\due_date\lib\common_widgets\theme.dart", "Dart", 0, 15, 1, 16
"c:\PROJECTS\FLUTTER\diverzum_due_date\due_date\lib\db_hive\data_model\data_object.dart", "Dart", 8, 0, 6, 14
"c:\PROJECTS\FLUTTER\diverzum_due_date\due_date\lib\db_hive\data_model\hive_dao.dart", "Dart", 14, 0, 9, 23
"c:\PROJECTS\FLUTTER\diverzum_due_date\due_date\lib\db_hive\data_model\hive_dao.g.dart", "Dart", 36, 4, 8, 48
"c:\PROJECTS\FLUTTER\diverzum_due_date\due_date\lib\db_hive\db_interfaces.dart", "Dart", 9, 0, 5, 14
"c:\PROJECTS\FLUTTER\diverzum_due_date\due_date\lib\db_hive\hive_control.dart", "Dart", 31, 1, 16, 48
"c:\PROJECTS\FLUTTER\diverzum_due_date\due_date\lib\dynamic_routes\routes.dart", "Dart", 34, 0, 8, 42
"c:\PROJECTS\FLUTTER\diverzum_due_date\due_date\lib\firebase\autentication\authentication_data_source.dart", "Dart", 9, 1, 2, 12
"c:\PROJECTS\FLUTTER\diverzum_due_date\due_date\lib\firebase\config.dart", "Dart", 12, 0, 2, 14
"c:\PROJECTS\FLUTTER\diverzum_due_date\due_date\lib\functions\date_recalculator.dart", "Dart", 13, 0, 1, 14
"c:\PROJECTS\FLUTTER\diverzum_due_date\due_date\lib\main.dart", "Dart", 51, 9, 15, 75
"c:\PROJECTS\FLUTTER\diverzum_due_date\due_date\lib\pages\bug_handler\bodies\bug_creator_body\bug_creator_body.dart", "Dart", 20, 2, 5, 27
"c:\PROJECTS\FLUTTER\diverzum_due_date\due_date\lib\pages\bug_handler\bodies\bug_creator_body\parts\bug_date_line.dart", "Dart", 72, 0, 13, 85
"c:\PROJECTS\FLUTTER\diverzum_due_date\due_date\lib\pages\bug_handler\bodies\bug_creator_body\parts\calculate_button.dart", "Dart", 41, 0, 8, 49
"c:\PROJECTS\FLUTTER\diverzum_due_date\due_date\lib\pages\bug_handler\bodies\bug_creator_body\parts\turnaround_time_line.dart", "Dart", 57, 0, 10, 67
"c:\PROJECTS\FLUTTER\diverzum_due_date\due_date\lib\pages\bug_handler\bodies\bug_list\bug_list_body.dart", "Dart", 18, 8, 7, 33
"c:\PROJECTS\FLUTTER\diverzum_due_date\due_date\lib\pages\bug_handler\bodies\bug_list\parts\bug_list_tile.dart", "Dart", 57, 0, 9, 66
"c:\PROJECTS\FLUTTER\diverzum_due_date\due_date\lib\pages\bug_handler\bug_handler_page.dart", "Dart", 105, 1, 24, 130
"c:\PROJECTS\FLUTTER\diverzum_due_date\due_date\lib\pages\login_page\login_page.dart", "Dart", 33, 0, 5, 38
"c:\PROJECTS\FLUTTER\diverzum_due_date\due_date\lib\pages\login_page\parts\head_widget.dart", "Dart", 17, 0, 3, 20
"c:\PROJECTS\FLUTTER\diverzum_due_date\due_date\lib\pages\login_page\parts\login_button.dart", "Dart", 41, 0, 8, 49
"c:\PROJECTS\FLUTTER\diverzum_due_date\due_date\lib\pages\login_page\parts\mail_data_line.dart", "Dart", 45, 0, 11, 56
"c:\PROJECTS\FLUTTER\diverzum_due_date\due_date\lib\pages\login_page\parts\password_data_line.dart", "Dart", 38, 1, 7, 46
"c:\PROJECTS\FLUTTER\diverzum_due_date\due_date\lib\state_machine\state_manager_bloc.dart", "Dart", 55, 2, 20, 77
"c:\PROJECTS\FLUTTER\diverzum_due_date\due_date\lib\state_machine\state_manager_event.dart", "Dart", 35, 0, 13, 48
"c:\PROJECTS\FLUTTER\diverzum_due_date\due_date\lib\state_machine\state_manager_state.dart", "Dart", 42, 0, 16, 58
"Total", "-", 1009, 45, 250, 1304